###New England###
CMM	= "countries/Canadian Mission of Maine.txt"
SOM	= "countries/State of Maine.txt"
MAR	= "countries/Maine Republic.txt"
USR	= "countries/United States Rhode Island Government.txt"
MCA	= "countries/Massachusetts-Connecticut Authority.txt"
NGM	= "countries/National Guard Government of Massachusetts.txt"
SNH	= "countries/State of New Hampshire.txt"
VER	= "countries/Vermont Republic.txt"
BRA	= "countries/Boston Red Army.txt"
WTB	= "countries/Watertown Brigade.txt"
ALB	= "countries/Albany Government.txt"
ROC	= "countries/Rochester Government.txt"
ITH	= "countries/Republic of Ithaca.txt"
SYR	= "countries/Syracuse Revolt.txt"
ERE	= "countries/Lake Erie Military Authority.txt"
HUD	= "countries/Hudson Valley Association.txt"
NYC	= "countries/Confederation of New York.txt"
LIS	= "countries/Long Island Military Authority.txt"
PEN	= "countries/Commonwealth of Pennslyvania.txt"
KEY	= "countries/Keystone Commune.txt"
PHI	= "countries/Philadelphia Administration.txt"
NJA	= "countries/New Jersey Military Authority.txt"
BAL	= "countries/Baltimore Republic.txt"

###Vanilla###
USA = "countries/USA.txt"
CUB = "countries/Cuba.txt"
DOM = "countries/Dominican Republic.txt"
HAI = "countries/Haiti.txt"
CAN = "countries/Canada.txt"
MEX = "countries/Mexico.txt"
BAH = "countries/Bahamas.txt"